00000000000000000000000000
00000000000000000000000000
00550055005500550055005500
00550055005500550055005500
00550055005500550055005500
00550055005500550055005500
00550055005511550055005500
00550055005511550055005500
00550055005500550055005500
00550000000000000000005500
00000000000000000000000000
00000000000000000000000000
00000000000000000000000000
00000000000000000000000000
00000000000000000000000000
00000000000000000000000000
55555555555555555555555555
55555555555555555555555555
00000000000000000000000000
00000000000000000000000000
00000000000000000000000000
00000000000000000000000000
00000000000000000000000000
00000000000000000000000000
00000000000000000000000000
00000000000000000000000000